TTTTTTTTTTTTTTTTTTTTTTTTTTTTTTTTTTTTTTTTTTTTTTTTTTTTT
T                                                   T
T     TTTTTTTTT                                     T
T                                                   T
T                                                   T
T                                                   T
T                                                   T
T                                                   T
T                                                   T
T                                                   T
T                                                   T
T                                                   T
T                                                   T
T                                                   T
T                                                   T
T                                                   T
TTTTTTTTTTTTTTTTTTTTTTTTTTTTTTTTTTTTTTTTTTTTTTTTTTTTT